local tmconf,omconf,tm,om,chars

tmconf = {
  
  "terrain/field/dirt",    --0
  "terrain/field/road",    --1
  "terrain/field/grass",   --2
  "terrain/field/gravel",  --3
  "terrain/cave/stone",    --4
  "terrain/cave/andesite", --5
  
}

omconf = {
  
  
  
}

--16*16
--tm = texturemap
--om = objectmap

tm = {
--  1  2  3  4  5  6  7  8  9  10 11 12 13 14 15 16
  { 3, 3, 2, 2, 2, 2, 1, 1, 1, 1, 2, 2, 2, 2, 2, 3}, --1
  { 3, 2, 2, 2, 2, 2, 1, 1, 1, 2, 2, 2, 2, 2, 3, 3}, --2
  { 3, 3, 2, 2, 2, 2, 1, 1, 1, 2, 2, 2, 2, 2, 3, 3}, --3
  { 3, 2, 2, 2, 2, 2, 1, 1, 1, 1, 2, 2, 2, 2, 3, 5}, --4
  { 3, 2, 2, 2, 2, 2, 1, 1, 1, 1, 2, 2, 2, 4, 4, 4}, --5
  { 5, 2, 4, 2, 2, 4, 2, 1, 1, 1, 2, 2, 4, 5, 4, 4}, --6
  { 4, 5, 2, 4, 4, 2, 1, 1, 1, 2, 2, 2, 2, 4, 3, 4}, --7
  { 3, 4, 4, 5, 4, 2, 1, 1, 1, 1, 2, 2, 2, 4, 2, 4}, --8
  { 3, 2, 2, 4, 4, 2, 1, 1, 1, 2, 2, 2, 2, 2, 3, 4}, --9
  { 4, 4, 4, 4, 2, 2, 2, 1, 1, 1, 2, 2, 2, 2, 3, 3}, --10
  { 4, 5, 4, 4, 5, 2, 2, 1, 1, 1, 2, 2, 2, 2, 2, 3}, --11
  { 4, 4, 2, 4, 2, 2, 1, 1, 1, 1, 2, 2, 2, 2, 3, 3}, --12
  { 4, 2, 2, 2, 2, 2, 1, 1, 1, 2, 2, 2, 2, 2, 2, 3}, --13
  { 3, 2, 2, 2, 2, 2, 1, 1, 1, 1, 2, 2, 2, 2, 2, 3}, --14
  { 3, 3, 2, 2, 2, 1, 1, 1, 1, 2, 2, 2, 2, 2, 3, 3}, --15
  { 3, 3, 2, 2, 1, 1, 1, 1, 1, 2, 2, 2, 2, 2, 2, 3}, --16
  
}

om = {
  
  --  1  2  3  4  5  6  7  8  9  10 11 12 13 14 15 16
  { 0, 0, 0, 0, 0, 0, 0, 0, 0, 0, 0, 0, 0, 0, 0, 0}, --1
  { 0, 0, 0, 0, 0, 0, 0, 0, 0, 0, 0, 0, 0, 0, 0, 0}, --2
  { 0, 0, 0, 0, 0, 0, 0, 0, 0, 0, 0, 0, 0, 0, 0, 0}, --3
  { 0, 0, 0, 0, 0, 0, 0, 0, 0, 0, 0, 0, 0, 0, 0, 0}, --4
  { 0, 0, 0, 0, 0, 0, 0, 0, 0, 0, 0, 0, 0, 0, 0, 0}, --5
  { 0, 0, 0, 0, 0, 0, 0, 0, 0, 0, 0, 0, 0, 0, 0, 0}, --6
  { 0, 0, 0, 0, 0, 0, 0, 0, 0, 0, 0, 0, 0, 0, 0, 0}, --7
  { 0, 0, 0, 0, 0, 0, 0, 0, 0, 0, 0, 0, 0, 0, 0, 0}, --8
  { 0, 0, 0, 0, 0, 0, 0, 0, 0, 0, 0, 0, 0, 0, 0, 0}, --9
  { 0, 0, 0, 0, 0, 0, 0, 0, 0, 0, 0, 0, 0, 0, 0, 0}, --10
  { 0, 0, 0, 0, 0, 0, 0, 0, 0, 0, 0, 0, 0, 0, 0, 0}, --11
  { 0, 0, 0, 0, 0, 0, 0, 0, 0, 0, 0, 0, 0, 0, 0, 0}, --12
  { 0, 0, 0, 0, 0, 0, 0, 0, 0, 0, 0, 0, 0, 0, 0, 0}, --13
  { 0, 0, 0, 0, 0, 0, 0, 0, 0, 0, 0, 0, 0, 0, 0, 0}, --14
  { 0, 0, 0, 0, 0, 0, 0, 0, 0, 0, 0, 0, 0, 0, 0, 0}, --15
  { 0, 0, 0, 0, 0, 0, 0, 0, 0, 0, 0, 0, 0, 0, 0, 0}, --16
  
}

return {
  tmconf = tmconf,
  omconf = omconf,
  tm     = tm,
  om     = om
}