local tmconf,omconf,tm,om,chars

tmconf = {
  
  "terrain/field/dirt",    --0
  "terrain/field/road",    --1
  "terrain/field/grass",   --2
  "terrain/field/gravel",  --3
  "terrain/cave/stone",    --4
  "terrain/cave/andesite", --5
  "terrain/beach/ocean"    --6
  
}

omconf = {
  
  "terrain/objects/bridge", --1
  "terrain/objects/tree",   --2
  "terrain/objects/fort",   --3
  "terrain/objects/road"    --4
  
}

--16*20
--tm = texturemap
--om = objectmap

tm = {
--  1  2  3  4  5  6  7  8  9  10 11 12 13 14 15 16
  { 2, 2, 2, 2, 2, 2, 2, 2, 2, 2, 2, 2, 2, 2, 2, 2}, --1
  { 2, 2, 2, 2, 5, 2, 2, 2, 2, 2, 2, 2, 2, 2, 2, 2}, --2
  { 2, 2, 2, 4, 5, 4, 3, 2, 2, 2, 2, 2, 2, 2, 2, 2}, --3
  { 2, 2, 2, 4, 2, 3, 2, 2, 2, 2, 2, 2, 4, 2, 2, 2}, --4
  { 6, 6, 6, 2, 2, 2, 2, 2, 2, 2, 2, 2, 2, 5, 4, 3}, --5
  { 2, 2, 6, 6, 6, 2, 2, 2, 2, 2, 2, 2, 2, 2, 2, 3}, --6
  { 2, 2, 2, 2, 6, 6, 6, 2, 2, 2, 2, 2, 2, 2, 2, 2}, --7
  { 2, 2, 2, 2, 2, 2, 6, 6, 2, 2, 2, 2, 2, 2, 2, 2}, --8
  { 2, 2, 2, 2, 2, 2, 2, 6, 6, 2, 2, 6, 6, 6, 2, 2}, --9
  { 2, 2, 2, 2, 2, 2, 2, 2, 6, 6, 6, 6, 2, 6, 6, 6}, --10
  { 2, 2, 2, 2, 2, 2, 2, 2, 2, 2, 2, 2, 2, 2, 2, 2}, --11
  { 2, 2, 2, 2, 2, 2, 2, 2, 2, 2, 2, 2, 2, 2, 2, 2}, --12
  { 2, 2, 2, 2, 2, 2, 2, 2, 2, 2, 2, 2, 2, 2, 2, 2}, --13
  { 2, 2, 2, 2, 2, 2, 2, 2, 2, 2, 2, 2, 2, 2, 2, 2}, --14
  { 2, 2, 4, 2, 2, 2, 2, 2, 2, 2, 2, 2, 2, 2, 2, 2}, --15
  { 2, 2, 5, 4, 2, 2, 2, 2, 2, 2, 2, 2, 2, 2, 2, 2}, --16
  { 2, 3, 5, 4, 2, 2, 2, 2, 2, 2, 2, 2, 2, 2, 2, 2}, --17
  { 2, 2, 2, 2, 2, 2, 2, 2, 2, 2, 2, 2, 2, 2, 2, 2}, --18
  { 2, 2, 2, 2, 2, 2, 2, 2, 2, 2, 2, 2, 2, 2, 2, 2}, --19
  { 2, 2, 2, 2, 2, 2, 2, 2, 2, 2, 2, 2, 2, 2, 2, 2}  --20
  
}

om = {
  
--  1  2  3  4  5  6  7  8  9  10 11 12 13 14 15 16
  { 0, 0, 0, 0, 0, 0, 0, 4, 0, 0, 0, 0, 0, 0, 2, 2}, --1
  { 0, 2, 0, 0, 0, 0, 0, 0, 4, 0, 0, 0, 0, 0, 2, 2}, --2
  { 0, 0, 0, 0, 0, 0, 0, 0, 4, 4, 0, 2, 0, 0, 0, 2}, --3
  { 0, 0, 2, 0, 0, 0, 0, 0, 0, 4, 0, 0, 0, 0, 0, 0}, --4
  { 0, 0, 0, 0, 0, 0, 0, 0, 0, 4, 0, 0, 0, 0, 0, 0}, --5
  { 0, 0, 0, 0, 0, 0, 0, 0, 3, 4, 4, 3, 0, 0, 0, 0}, --6
  { 0, 0, 0, 0, 0, 0, 0, 0, 0, 0, 4, 0, 2, 0, 0, 0}, --7
  { 0, 0, 0, 0, 0, 2, 0, 0, 0, 0, 4, 0, 0, 0, 2, 0}, --8
  { 0, 0, 2, 2, 0, 0, 0, 0, 0, 4, 4, 0, 0, 0, 0, 0}, --9
  { 0, 0, 0, 0, 0, 0, 0, 0, 0, 1, 1, 0, 0, 0, 0, 0}, --10
  { 0, 0, 0, 0, 0, 0, 0, 0, 0, 4, 4, 0, 0, 0, 0, 0}, --11
  { 0, 2, 2, 0, 0, 0, 0, 0, 3, 4, 4, 3, 0, 2, 2, 0}, --12
  { 0, 2, 2, 0, 0, 2, 0, 0, 0, 4, 0, 0, 0, 0, 0, 0}, --13
  { 0, 0, 0, 0, 0, 2, 0, 4, 4, 4, 0, 0, 0, 0, 0, 0}, --14
  { 0, 0, 0, 0, 0, 2, 0, 0, 4, 0, 0, 0, 2, 2, 0, 0}, --15
  { 0, 0, 0, 0, 0, 0, 0, 4, 4, 0, 0, 0, 2, 2, 0, 0}, --16
  { 0, 0, 0, 0, 0, 0, 0, 4, 4, 0, 0, 0, 2, 2, 0, 0}, --17
  { 0, 0, 0, 0, 0, 0, 4, 4, 4, 0, 0, 0, 0, 0, 0, 0}, --18
  { 0, 0, 0, 2, 0, 0, 4, 0, 0, 0, 0, 0, 0, 2, 2, 0}, --19
  { 0, 0, 2, 2, 0, 0, 4, 0, 0, 0, 2, 2, 0, 0, 0, 0}  --20
  
}

return {
  tmconf = tmconf,
  omconf = omconf,
  tm     = tm,
  om     = om
}